BBBBBBBBBBBBBBBBBBBBBBBBBBBBBB
B0000000000000000000000000000B
B0000000000000000000000000000B
B000B00000000000000000000B000B
B000B00000000000000000000B000B
B000B00000000000000000000B000B
B000B0000B0000000000B0000B000B
B000B0000B0000000000B0000B000B
B000B0000B0000000000B0000B000B
B000B0000B0000000000B0000B000B
B000B0000B0000000000B0000B000B
B000B00000000000000000000B000B
B000B00000000000000BBB0000000B
B0000000BBBBBB000000000000000B
B0000000000000000000000000000B
B0000000000000000000000000000B
B000000000000000BBBBBB0000000B
B0000000BBB00000000000000B000B
B000B00000000000000000000B000B
B000B00000000000000000000B000B
B000B0000B0000000000B0000B000B
B000B0000B0000000000B0000B000B
B000B0000B0000000000B0000B000B
B000B0000B0000000000B0000B000B
B000B0000B0000000000B0000B000B
B000B00000000000000000000B000B
B000B00000000000000000000B000B
B0000000000000000000000000000B
B0000000000000000000000000000B
BBBBBBBBBBBBBBBBBBBBBBBBBBBBBB